AAX=Araxá
ABJ=Abidjan - Costa do Marfim
ADA=Adana Incirlik
ADW=Andrews AFB
AFE=Alfenas
AGA=Agadir - Marrocos
AGP=Malaga - Espanha
AGT=Ciudad Del Este 
AIF=Assis - São Paulo
AJU=Aracaju
AKL=Auckland 
AMS=Amsterdam
ANU=Antigua
AQA=Araraquara
ARU=Araçatuba
ASU=Asunção
ATH=Athenas 
ATL=Atlanta
ATM=Altamira
AUA=Aruba
AUH=Abu Dhabi - Emirados Arabes
AUX=Araguaína
AVR=Avaré 
BAQ=Barranquilla
BAT=Barretos
BAU=Bauru
BBU=Bucarest
BCN=Barcelona
BEL=Belém
BEY=Beirut
BGI=Barbados 
BGW=Baghdad
BOG=Bogotá
BON=Bonaire
BOS=Boston
BPS=Porto Seguro
BQI=AGUADILLA - PORTO RICO
BRC=Bariloche
BRU=Bruxelles
BSB=Brasília
BUD=Budapest
BUE=Buenos Aires
BVB=Boa Vista
BVH=Vilhena
BYO=Bonito
BZC=Búzios
CAC=Cascavel
CAI=Cairo
CAS=Casablanca
CAU=Caruaru
CAW=Campos
CAY=Caiena
CBB=Cochabamba
CCM=Criciúma
CCS=Caracas
CDG=Paris C.de Gaulle
CFB=Cabo Frio
CGB=Cuiabá
CGH=Congonhas - SP
CGN=Colonia Alemanha
CGR=Campo Grande
CKS=Carajás
CKY=Conakry
CLO=Cali
CLV=Caldas Novas
CMG=Corumbá
CNF=Belo Horizonte
COR=Córdoba
CPH=Copenhagen
CPQ=Campinas
CPT=Cape Town
CPV=Campina GDE
CTG=Cartagena
CUN=Cancun
CUR=Curaçao
CUZ=Cuzco
CVG=Cincinnati
CWB=Curitiba
CXJ=Caxias do Sul
CZS=Cruzeiro do Sul
DAM=Damascus
DFW=Dallas
DIQ=Divinópolis
DKR=Dakkar
DME=Moscow Domodedovo
DUB=Dublin Eire
DUS=Dusseldorf
DXB=Dubai Int.Airtport
EDI=Edinburgh
EWR=New York - Newark
FCO=Rome
FDF=Fort de France Martinique
FEN=Fernando de Noronha
FLL=F. Lauderdale
FLN=Florianópolis
FNC=Funchal- Ilha da Madeira
FOR=Fortaleza
FRA=Frankfurt
FRC=Franca
GDL=Guadalajara
GEL=Santo Ângelo
GEO=Georgetown
GIG=Rio de Janeiro
GMP=Seoul
GRP=Gurupi-Tocantins
GRU=Retorno GRU
GSO=Greensboro Carol. do Norte
GVA=Geneve
GVR=Governador Valadares
GYE=Guayaquil Equador
GYN=Goiânia
HAJ=Hannover
HAM=Hamburg
HAV=Havana
HKG=Hong Kong
HPN=Westchester CO
HRL=Harlingen
HUX=Huatulco
IAD=Washington Dulles
IAH=Houston
IGP=Gav Peixoto
IGR=Puerto Iguazu
IGU=Foz do Iguaçú
IMP=Imperatriz
IND=Indianapolis
IOS=Ilhéus
IPN=Ipatinga
IST=Istambu
JDF=Juíz de Fora
JDO=Juazeiro Norte
JFK=New York JFK
JNB=Johannesburg
JOI=Joinville
JPA=João Pessoa
JPR=Ji-Paraná
KIX=Osaka
LAD=Luanda
LAJ=Lages
LAS=Las Vegas
LAX=Los Angeles
LCA=Larnaca
LDB=Londrina
LEC=Lençois
LFW=Lome
LGA=New York La Guardia
LGS=Las Lenas  Malargue
LGW=Londres Gatwick
LHR=Londres Heathrow
LIM=Lima
LIN=Milan
LIP=Lins
LIS=Lisboa
LON=Londres
LOS=Lagos
LPA=Las Palmas
LPB=La Paz
LUX=Luxemburgo
MAB=MarabÃ¡
MAD=Madrid
MAO=Manaus
MBJ=Montego Bay
MCO=Orlando
MCP=Macapá
MCZ=Maceió
MDE=Medellin
MDQ=Mar del Plata
MDZ=Mendoza
MEA=MacaÃ©
MEX=México
MGA=Managua
MGF=Maringá
MIA=Miami
MID=Merida
MII=Marília
MIL=Milan
MOC=Montes Claros
MOW=Moscow
MPM=Maputo
MPN=Falkland
MSY=New Orleans
MUC=Munich
MVD=Montevideo
MVF=Mossoró
MXP=Milan Malpensa
MYC=Maracay El Libertador
NAP=Napoli
NAS=Nassau
NAT=Natal
NGO=Nagoya
NPR=Caximbo
NRT=Narita Tókio
NVT=Navegantes
NYC=New York
OPO=Porto
OPS=Sinop Faz.Boa Esperança
ORD=Chicago - O'Hare
ORY=Paris Orly
OSL=Oslo Noruega
OUS=Ourinhos
PAR=Paris
PAV=Paulo Afonso
PBI=Palm Beach Flórida
PBM=Paramaribo
PDP=Punta del Leste
PEK=Beijing Pequim
PFB=Passo Fundo
PGZ=Ponta Grossa
PHL=Philadelphia
PHX=Phoenix
PIN=Parintins
PLU=Belo Horizonte
PMC=Puerto Montt Chile
PMG=Ponta Pora
PMI=Palma Mallorca
PMV=I. Marguerita
PMW=Palmas
PNB=Porto Nacional
PNZ=Petrolina
POA=Porto Alegre
POJ=Patos de Minas
POS=Port of Spain
PPB=P. Prudente
PPV=P. Primavera
PRA=Paraná-Argentina
PSO=Pasto
PSZ=Puerto Suarez
PTO=Pato Branco
PTP=Pointe a Pitre
PTY=Panama City
PUJ=Punta Cana
PUQ=Punta Arenas
PVH=Porto Velho
PXO=Porto Santo I.da Madeira
QPS=Pirassununga
QSC=São Carlos
RAK=Marrakesh
RAO=Ribeirão Preto
RBR=Rio Branco
REC=Recife
RIA=Santa Maria
RIX=Rigga
ROM=Rome
ROS=Rosário
SCL=Santiago
SDF=Standford
SDU=Rio de Janeiro
SEA=Seattle
SFN=Santa Fe-Argentina
SFO=San Francisco
SID=Ilha do Sal
SJK=S.J. dos Campos
SJO=San Jose
SJP=S J Rio Preto
SJR=São João Del Rei  
SJU=San Juan
SLA=Salta
SLZ=São Luis
SOD=Sorocaba
SRE=Sucre
SRZ=S.C. La Sierra
SSA=Salvador
STM=Santarém
STT=St Tomas - Ilhas Virgens - Caribe
SVO=Moscow - Sheremetyevo
SXF=Berlin
SXM=San Marteen
SYD=Sydney
TEC=Telêmaco Borba
TFS=S.C.Tenerife
THE=Teresina
TLS=Tolouse
TLV=Telaviv
TPA=Tampa Bay
TRN=Turin
TUC=Tucuman
TUL=Tulsa
TUR=Tucuruí
UBA=Uberaba
UDI=Uberlândia
UIO=Quito
UNA=Comandatuba
URB=Urubupunga
VAG=Varginha
VAL=Valença- Bahia
VCP=Campinas
VDC=Vitória da Conquista
VIA=Videira
VIE=Wien
VIX=Vitória
VLC=Valencia - Espanha
VRO=Varadero
VVI=VIRO VIRO - STA.CRUZ LA SIERA
XAP=Chapecó
YMX=Montreal - Mirabel
YUL=Montreal - Dorval
YVR=Vancouver
YYZ=Toronto
ZRH=Zurich
